af-ZA-AdriNeural - Female - af-ZA
af-ZA-WillemNeural - Male - af-ZA
sq-AL-AnilaNeural - Female - sq-AL
sq-AL-IlirNeural - Male - sq-AL
am-ET-AmehaNeural - Male - am-ET
am-ET-MekdesNeural - Female - am-ET
ar-DZ-AminaNeural - Female - ar-DZ
ar-DZ-IsmaelNeural - Male - ar-DZ
ar-BH-AliNeural - Male - ar-BH
ar-BH-LailaNeural - Female - ar-BH
ar-EG-SalmaNeural - Female - ar-EG
ar-EG-ShakirNeural - Male - ar-EG
ar-IQ-BasselNeural - Male - ar-IQ
ar-IQ-RanaNeural - Female - ar-IQ
ar-JO-SanaNeural - Female - ar-JO
ar-JO-TaimNeural - Male - ar-JO
ar-KW-FahedNeural - Male - ar-KW
ar-KW-NouraNeural - Female - ar-KW
ar-LB-LaylaNeural - Female - ar-LB
ar-LB-RamiNeural - Male - ar-LB
ar-LY-ImanNeural - Female - ar-LY
ar-LY-OmarNeural - Male - ar-LY
ar-MA-JamalNeural - Male - ar-MA
ar-MA-MounaNeural - Female - ar-MA
ar-OM-AbdullahNeural - Male - ar-OM
ar-OM-AyshaNeural - Female - ar-OM
ar-QA-AmalNeural - Female - ar-QA
ar-QA-MoazNeural - Male - ar-QA
ar-SA-HamedNeural - Male - ar-SA
ar-SA-ZariyahNeural - Female - ar-SA
ar-SY-AmanyNeural - Female - ar-SY
ar-SY-LaithNeural - Male - ar-SY
ar-TN-HediNeural - Male - ar-TN
ar-TN-ReemNeural - Female - ar-TN
ar-AE-FatimaNeural - Female - ar-AE
ar-AE-HamdanNeural - Male - ar-AE
ar-YE-MaryamNeural - Female - ar-YE
ar-YE-SalehNeural - Male - ar-YE
az-AZ-BabekNeural - Male - az-AZ
az-AZ-BanuNeural - Female - az-AZ
bn-BD-NabanitaNeural - Female - bn-BD
bn-BD-PradeepNeural - Male - bn-BD
bn-IN-BashkarNeural - Male - bn-IN
bn-IN-TanishaaNeural - Female - bn-IN
bs-BA-VesnaNeural - Female - bs-BA
bs-BA-GoranNeural - Male - bs-BA
bg-BG-BorislavNeural - Male - bg-BG
bg-BG-KalinaNeural - Female - bg-BG
my-MM-NilarNeural - Female - my-MM
my-MM-ThihaNeural - Male - my-MM
ca-ES-EnricNeural - Male - ca-ES
ca-ES-JoanaNeural - Female - ca-ES
zh-HK-HiuGaaiNeural - Female - zh-HK
zh-HK-HiuMaanNeural - Female - zh-HK
zh-HK-WanLungNeural - Male - zh-HK
zh-CN-XiaoxiaoNeural - Female - zh-CN
zh-CN-XiaoyiNeural - Female - zh-CN
zh-CN-YunjianNeural - Male - zh-CN
zh-CN-YunxiNeural - Male - zh-CN
zh-CN-YunxiaNeural - Male - zh-CN
zh-CN-YunyangNeural - Male - zh-CN
zh-CN-liaoning-XiaobeiNeural - Female - zh-CN-liaoning
zh-TW-HsiaoChenNeural - Female - zh-TW
zh-TW-YunJheNeural - Male - zh-TW
zh-TW-HsiaoYuNeural - Female - zh-TW
zh-CN-shaanxi-XiaoniNeural - Female - zh-CN-shaanxi
hr-HR-GabrijelaNeural - Female - hr-HR
hr-HR-SreckoNeural - Male - hr-HR
cs-CZ-AntoninNeural - Male - cs-CZ
cs-CZ-VlastaNeural - Female - cs-CZ
da-DK-ChristelNeural - Female - da-DK
da-DK-JeppeNeural - Male - da-DK
nl-BE-ArnaudNeural - Male - nl-BE
nl-BE-DenaNeural - Female - nl-BE
nl-NL-ColetteNeural - Female - nl-NL
nl-NL-FennaNeural - Female - nl-NL
nl-NL-MaartenNeural - Male - nl-NL
en-AU-NatashaNeural - Female - en-AU
en-AU-WilliamNeural - Male - en-AU
en-CA-ClaraNeural - Female - en-CA
en-CA-LiamNeural - Male - en-CA
en-HK-YanNeural - Female - en-HK
en-HK-SamNeural - Male - en-HK
en-IN-NeerjaExpressiveNeural - Female - en-IN
en-IN-NeerjaNeural - Female - en-IN
en-IN-PrabhatNeural - Male - en-IN
en-IE-ConnorNeural - Male - en-IE
en-IE-EmilyNeural - Female - en-IE
en-KE-AsiliaNeural - Female - en-KE
en-KE-ChilembaNeural - Male - en-KE
en-NZ-MitchellNeural - Male - en-NZ
en-NZ-MollyNeural - Female - en-NZ
en-NG-AbeoNeural - Male - en-NG
en-NG-EzinneNeural - Female - en-NG
en-PH-JamesNeural - Male - en-PH
en-PH-RosaNeural - Female - en-PH
en-US-AvaNeural - Female - en-US
en-US-AndrewNeural - Male - en-US
en-US-EmmaNeural - Female - en-US
en-US-BrianNeural - Male - en-US
en-SG-LunaNeural - Female - en-SG
en-SG-WayneNeural - Male - en-SG
en-ZA-LeahNeural - Female - en-ZA
en-ZA-LukeNeural - Male - en-ZA
en-TZ-ElimuNeural - Male - en-TZ
en-TZ-ImaniNeural - Female - en-TZ
en-GB-LibbyNeural - Female - en-GB
en-GB-MaisieNeural - Female - en-GB
en-GB-RyanNeural - Male - en-GB
en-GB-SoniaNeural - Female - en-GB
en-GB-ThomasNeural - Male - en-GB
en-US-AnaNeural - Female - en-US
en-US-AndrewMultilingualNeural - Male - en-US
en-US-AriaNeural - Female - en-US
en-US-AvaMultilingualNeural - Female - en-US
en-US-BrianMultilingualNeural - Male - en-US
en-US-ChristopherNeural - Male - en-US
en-US-EmmaMultilingualNeural - Female - en-US
en-US-EricNeural - Male - en-US
en-US-GuyNeural - Male - en-US
en-US-JennyNeural - Female - en-US
en-US-MichelleNeural - Female - en-US
en-US-RogerNeural - Male - en-US
en-US-SteffanNeural - Male - en-US
et-EE-AnuNeural - Female - et-EE
et-EE-KertNeural - Male - et-EE
fil-PH-AngeloNeural - Male - fil-PH
fil-PH-BlessicaNeural - Female - fil-PH
fi-FI-HarriNeural - Male - fi-FI
fi-FI-NooraNeural - Female - fi-FI
fr-BE-CharlineNeural - Female - fr-BE
fr-BE-GerardNeural - Male - fr-BE
fr-CA-ThierryNeural - Male - fr-CA
fr-CA-AntoineNeural - Male - fr-CA
fr-CA-JeanNeural - Male - fr-CA
fr-CA-SylvieNeural - Female - fr-CA
fr-FR-VivienneMultilingualNeural - Female - fr-FR
fr-FR-RemyMultilingualNeural - Male - fr-FR
fr-FR-DeniseNeural - Female - fr-FR
fr-FR-EloiseNeural - Female - fr-FR
fr-FR-HenriNeural - Male - fr-FR
fr-CH-ArianeNeural - Female - fr-CH
fr-CH-FabriceNeural - Male - fr-CH
gl-ES-RoiNeural - Male - gl-ES
gl-ES-SabelaNeural - Female - gl-ES
ka-GE-EkaNeural - Female - ka-GE
ka-GE-GiorgiNeural - Male - ka-GE
de-AT-IngridNeural - Female - de-AT
de-AT-JonasNeural - Male - de-AT
de-DE-SeraphinaMultilingualNeural - Female - de-DE
de-DE-FlorianMultilingualNeural - Male - de-DE
de-DE-AmalaNeural - Female - de-DE
de-DE-ConradNeural - Male - de-DE
de-DE-KatjaNeural - Female - de-DE
de-DE-KillianNeural - Male - de-DE
de-CH-JanNeural - Male - de-CH
de-CH-LeniNeural - Female - de-CH
el-GR-AthinaNeural - Female - el-GR
el-GR-NestorasNeural - Male - el-GR
gu-IN-DhwaniNeural - Female - gu-IN
gu-IN-NiranjanNeural - Male - gu-IN
he-IL-AvriNeural - Male - he-IL
he-IL-HilaNeural - Female - he-IL
hi-IN-MadhurNeural - Male - hi-IN
hi-IN-SwaraNeural - Female - hi-IN
hu-HU-NoemiNeural - Female - hu-HU
hu-HU-TamasNeural - Male - hu-HU
is-IS-GudrunNeural - Female - is-IS
is-IS-GunnarNeural - Male - is-IS
id-ID-ArdiNeural - Male - id-ID
id-ID-GadisNeural - Female - id-ID
iu-Latn-CA-SiqiniqNeural - Female - iu-Latn-CA
iu-Latn-CA-TaqqiqNeural - Male - iu-Latn-CA
iu-Cans-CA-SiqiniqNeural - Female - iu-Cans-CA
iu-Cans-CA-TaqqiqNeural - Male - iu-Cans-CA
ga-IE-ColmNeural - Male - ga-IE
ga-IE-OrlaNeural - Female - ga-IE
it-IT-GiuseppeMultilingualNeural - Male - it-IT
it-IT-DiegoNeural - Male - it-IT
it-IT-ElsaNeural - Female - it-IT
it-IT-IsabellaNeural - Female - it-IT
ja-JP-KeitaNeural - Male - ja-JP
ja-JP-NanamiNeural - Female - ja-JP
jv-ID-DimasNeural - Male - jv-ID
jv-ID-SitiNeural - Female - jv-ID
kn-IN-GaganNeural - Male - kn-IN
kn-IN-SapnaNeural - Female - kn-IN
kk-KZ-AigulNeural - Female - kk-KZ
kk-KZ-DauletNeural - Male - kk-KZ
km-KH-PisethNeural - Male - km-KH
km-KH-SreymomNeural - Female - km-KH
ko-KR-HyunsuMultilingualNeural - Male - ko-KR
ko-KR-InJoonNeural - Male - ko-KR
ko-KR-SunHiNeural - Female - ko-KR
lo-LA-ChanthavongNeural - Male - lo-LA
lo-LA-KeomanyNeural - Female - lo-LA
lv-LV-EveritaNeural - Female - lv-LV
lv-LV-NilsNeural - Male - lv-LV
lt-LT-LeonasNeural - Male - lt-LT
lt-LT-OnaNeural - Female - lt-LT
mk-MK-AleksandarNeural - Male - mk-MK
mk-MK-MarijaNeural - Female - mk-MK
ms-MY-OsmanNeural - Male - ms-MY
ms-MY-YasminNeural - Female - ms-MY
ml-IN-MidhunNeural - Male - ml-IN
ml-IN-SobhanaNeural - Female - ml-IN
mt-MT-GraceNeural - Female - mt-MT
mt-MT-JosephNeural - Male - mt-MT
mr-IN-AarohiNeural - Female - mr-IN
mr-IN-ManoharNeural - Male - mr-IN
mn-MN-BataaNeural - Male - mn-MN
mn-MN-YesuiNeural - Female - mn-MN
ne-NP-HemkalaNeural - Female - ne-NP
ne-NP-SagarNeural - Male - ne-NP
nb-NO-FinnNeural - Male - nb-NO
nb-NO-PernilleNeural - Female - nb-NO
ps-AF-GulNawazNeural - Male - ps-AF
ps-AF-LatifaNeural - Female - ps-AF
fa-IR-DilaraNeural - Female - fa-IR
fa-IR-FaridNeural - Male - fa-IR
pl-PL-MarekNeural - Male - pl-PL
pl-PL-ZofiaNeural - Female - pl-PL
pt-BR-ThalitaMultilingualNeural - Female - pt-BR
pt-BR-AntonioNeural - Male - pt-BR
pt-BR-FranciscaNeural - Female - pt-BR
pt-PT-DuarteNeural - Male - pt-PT
pt-PT-RaquelNeural - Female - pt-PT
ro-RO-AlinaNeural - Female - ro-RO
ro-RO-EmilNeural - Male - ro-RO
ru-RU-DmitryNeural - Male - ru-RU
ru-RU-SvetlanaNeural - Female - ru-RU
sr-RS-NicholasNeural - Male - sr-RS
sr-RS-SophieNeural - Female - sr-RS
si-LK-SameeraNeural - Male - si-LK
si-LK-ThiliniNeural - Female - si-LK
sk-SK-LukasNeural - Male - sk-SK
sk-SK-ViktoriaNeural - Female - sk-SK
sl-SI-PetraNeural - Female - sl-SI
sl-SI-RokNeural - Male - sl-SI
so-SO-MuuseNeural - Male - so-SO
so-SO-UbaxNeural - Female - so-SO
es-AR-ElenaNeural - Female - es-AR
es-AR-TomasNeural - Male - es-AR
es-BO-MarceloNeural - Male - es-BO
es-BO-SofiaNeural - Female - es-BO
es-CL-CatalinaNeural - Female - es-CL
es-CL-LorenzoNeural - Male - es-CL
es-CO-GonzaloNeural - Male - es-CO
es-CO-SalomeNeural - Female - es-CO
es-ES-XimenaNeural - Female - es-ES
es-CR-JuanNeural - Male - es-CR
es-CR-MariaNeural - Female - es-CR
es-CU-BelkysNeural - Female - es-CU
es-CU-ManuelNeural - Male - es-CU
es-DO-EmilioNeural - Male - es-DO
es-DO-RamonaNeural - Female - es-DO
es-EC-AndreaNeural - Female - es-EC
es-EC-LuisNeural - Male - es-EC
es-SV-LorenaNeural - Female - es-SV
es-SV-RodrigoNeural - Male - es-SV
es-GQ-JavierNeural - Male - es-GQ
es-GQ-TeresaNeural - Female - es-GQ
es-GT-AndresNeural - Male - es-GT
es-GT-MartaNeural - Female - es-GT
es-HN-CarlosNeural - Male - es-HN
es-HN-KarlaNeural - Female - es-HN
es-MX-DaliaNeural - Female - es-MX
es-MX-JorgeNeural - Male - es-MX
es-NI-FedericoNeural - Male - es-NI
es-NI-YolandaNeural - Female - es-NI
es-PA-MargaritaNeural - Female - es-PA
es-PA-RobertoNeural - Male - es-PA
es-PY-MarioNeural - Male - es-PY
es-PY-TaniaNeural - Female - es-PY
es-PE-AlexNeural - Male - es-PE
es-PE-CamilaNeural - Female - es-PE
es-PR-KarinaNeural - Female - es-PR
es-PR-VictorNeural - Male - es-PR
es-ES-AlvaroNeural - Male - es-ES
es-ES-ElviraNeural - Female - es-ES
es-US-AlonsoNeural - Male - es-US
es-US-PalomaNeural - Female - es-US
es-UY-MateoNeural - Male - es-UY
es-UY-ValentinaNeural - Female - es-UY
es-VE-PaolaNeural - Female - es-VE
es-VE-SebastianNeural - Male - es-VE
su-ID-JajangNeural - Male - su-ID
su-ID-TutiNeural - Female - su-ID
sw-KE-RafikiNeural - Male - sw-KE
sw-KE-ZuriNeural - Female - sw-KE
sw-TZ-DaudiNeural - Male - sw-TZ
sw-TZ-RehemaNeural - Female - sw-TZ
sv-SE-MattiasNeural - Male - sv-SE
sv-SE-SofieNeural - Female - sv-SE
ta-IN-PallaviNeural - Female - ta-IN
ta-IN-ValluvarNeural - Male - ta-IN
ta-MY-KaniNeural - Female - ta-MY
ta-MY-SuryaNeural - Male - ta-MY
ta-SG-AnbuNeural - Male - ta-SG
ta-SG-VenbaNeural - Female - ta-SG
ta-LK-KumarNeural - Male - ta-LK
ta-LK-SaranyaNeural - Female - ta-LK
te-IN-MohanNeural - Male - te-IN
te-IN-ShrutiNeural - Female - te-IN
th-TH-NiwatNeural - Male - th-TH
th-TH-PremwadeeNeural - Female - th-TH
tr-TR-EmelNeural - Female - tr-TR
tr-TR-AhmetNeural - Male - tr-TR
uk-UA-OstapNeural - Male - uk-UA
uk-UA-PolinaNeural - Female - uk-UA
ur-IN-GulNeural - Female - ur-IN
ur-IN-SalmanNeural - Male - ur-IN
ur-PK-AsadNeural - Male - ur-PK
ur-PK-UzmaNeural - Female - ur-PK
uz-UZ-MadinaNeural - Female - uz-UZ
uz-UZ-SardorNeural - Male - uz-UZ
vi-VN-HoaiMyNeural - Female - vi-VN
vi-VN-NamMinhNeural - Male - vi-VN
cy-GB-AledNeural - Male - cy-GB
cy-GB-NiaNeural - Female - cy-GB
zu-ZA-ThandoNeural - Female - zu-ZA
zu-ZA-ThembaNeural - Male - zu-ZA
